James - 詹姆斯
John - 約翰
Robert - 羅伯特
Michael - 邁克爾
William - 威廉
David - 大衛
Richard - 理查德
Joseph - 約瑟夫
Charles - 查爾斯
Thomas - 湯姆斯
Christopher - 克里斯托弗
Daniel - 丹尼爾
Paul - 保羅
Mark - 馬克
George - 喬治
Kenneth - 肯尼思
Steven - 史蒂文
Edward - 愛德華
Brian - 布萊恩
Ronald - 羅納德
Anthony - 安東尼
Kevin - 凱文
Jason - 傑森
Matthew - 馬修
Gary - 加里
Timothy - 提摩西
Jose - 何塞
Larry - 拉里
Jeffrey - 傑弗裡
Frank - 弗蘭克
Scott - 斯科特
Eric - 埃里克
Stephen - 斯蒂芬
Andrew - 安德魯
Raymond - 雷蒙德
Gregory - 格雷戈里
Joshua - 約書亞
Jerry - 傑瑞
Dennis - 丹尼斯
Walter - 沃爾特
Patrick - 帕特里克
Peter - 彼得
Harold - 哈羅德
Douglas - 道格拉斯
Henry - 亨利
Carl - 卡爾
Arthur - 亞瑟
Ryan - 瑞安
Roger - 羅傑
Joe - 喬
Mary - 瑪麗
Patricia - 帕特里夏
Linda - 琳達
Barbara - 芭芭拉
Elizabeth - 伊麗莎白
Jennifer - 珍妮弗
Maria - 瑪麗亞
Susan - 蘇珊
Margaret - 瑪格麗特
Dorothy - 多蘿西
Lisa - 麗莎
Nancy - 南希
Karen - 凱倫
Betty - 貝蒂
Helen - 海倫
Sandra - 桑德拉
Donna - 唐娜
Carol - 卡羅爾
Ruth - 露絲
Sharon - 莎倫
Michelle - 米歇爾
Laura - 勞拉
Sarah - 薩拉
Kimberly - 金佰莉
Deborah - 黛博拉
Jessica - 傑西卡
Shirley - 雪莉
Cynthia - 辛西婭
Angela - 安吉拉
Melissa - 梅麗莎
Brenda - 布倫達
Amy - 艾米
Anna - 安娜
Rebecca - 麗貝卡
Virginia - 維吉尼亞
Kathleen - 凱瑟琳
Pamela - 帕梅拉
Martha - 瑪莎
Debra - 黛布拉
Amanda - 阿曼達
Stephanie - 斯蒂芬妮
Carolyn - 卡羅琳
Christine - 克里斯汀
Marie - 瑪麗
Janet - 珍妮特
Catherine - 凱瑟琳
Frances - 弗朗西斯
Ann - 安
Joyce - 喬伊斯
Diane - 戴安